000000X00X00X0000000000X00X00X000000
000000000000000X00000000000000000000
000X00000000000X00000X00000000000000
00000XXX0000000X0000000XXX0000000000
000000000000000X00000000000000000000
000000000000000X00000000000000000000
000000000000X00X00000000000000X00000
000000000000000X00000000000000000000
000000X00X00X00X00000000X00X00X00000
000000000000000X00000000000000000000
000X00000000000X00000X00000000000000
00000XXX0000000X0000000XXX0000000000
000000000000000X00000000000000000000
000000000000000X00000000000000000000
000000000000X00X00000000000000X00000
000000000000000000000000000000000000
