00000X00X00X000000
000000000000000000
00X000000000000000
0000XXX00000000000
000000000000000000
000000000000000000
00000000000X000000
000000000000000000
